E  ############################
         #  #  #     #        #
#  #######  #  #  #  #  ####  #
#                 #  #  #     #
####  #######  ####  #  ####  #
#           #     #     #     #
#  #######  #  ####  #######  #
#  #        #  #     #        #
#############  ####  ##########
#  #  #           #        #  #
#  #  #  #######  ####  ####  #
#  #  #     #  #  #           #
#  #  #  ####  ####  #######  #
#  #  #        #        #     #
#  #  #  #  #######  #  #  ####
#  #     #     #     #  #     #
#  #  ################  #######
#              #              #
####  #  ####  ####  #  ####  #
#     #  #     #     #  #     
###########################   S 


